1 2 2 6 6 0 2 3 6 4 0 4 2 2 6 1 2 4 6 2
1 1 1 8 8 0 2 2 6 6 0 1 4 8 2 1 3 3 4 4
1 2 2 6 6 0 2 4 6 2 0 4 2 2 6
1 1 1 8 8 0 2 2 6 6 0 4 1 2 8 0 1 4 8 2
1 1 1 8 8 0 4 1 2 8 0 1 4 8 2